 . . . . . . . . M .
 3 3 . . . . . . . .
 3 . . . . . . . . .
 3 . . . . . . . . .
 . S . 2 . . . . . .
 . . . 2 . . . . 0 .
 1 1 . 2 . . . 0 0 0
 1 1 . . . . . . 0 .
 . . . . . . . . . .
 . . . 4 4 . . . . .
