 . . . . . . . . . .
 . . S 1 . . . . . .
 . . . . 1 1 1 1 . .
 M . . . . . . . . .
 . . . . . . . . . .
 . . . . . 2 . . . .
 . . . . . 2 . . . .
 . 3 3 3 . 2 . . . .
 . . . . . . . . . .
 0 0 0 0 0 . . . 4 4
