 . . 3 . . . . . . .
 . . . 3 . . . . . .
 . . . . 3 . . 0 . 0
 . . . . . . . . 0 .
 2 . . . . 1 . . 0 .
 . 2 . . 1 . 1 . 0 .
 . . 2 . . 1 1 . . .
 M . . . . . . . S .
 . . . 4 4 . . . . .
 . . . . . . . . . .
